........#..........
........#@####.....
........###........
...................
...................
...................
...................
...................
..................<
%..................