#########...%##
#....|.##.#
###...##..
####..##.#
##...##...
##@...##..
#.........
####.#####
#.....<###
#>.....#
####.####
......CCC
K........