...###.....
..##C#.####
.##..#.#C-#
##K$......#
#.$....#..#
###..#.#.|#
.....#@..%#
.##.####.##
C#.......#
.#.....##