@.%$..........|||.......TTTTTTTTTT.........K
...$....................TTTTTTTTTT.#########
$$$$....................TTTTTTTTTT..........
........................TTTTTTTTTT#########.
........................TTTTTTTTTT..........
........................TTTTTTTTTT.#########
.......................-TTTTTTTTTT..........
.......................-TTTTTTTTTT#########.
........................TTTTTTTTTT..........
$$.....................LTTTTTTTTTTL#########
L$......................TTTTTTTTTTTTTTTTTTTT
TTTTTTTTTTTTTTTTTTTTTTTTTTTTTTTTTTTTTTTTTTTT
TTTTTTTTTTTTTTTTTTTTTTTTTTTTTTTTTTTTTTTTTTTT
TTTTTTTTTTTTTTTTTTTTTTTTTTTTTTTTTTTTTTTTTTTT
TTTTTTTTTTTTTTTTTTTTTTTTTTTTTTTTTTTTTTTTTTTT
TTTTTTTTTTTTTTTTTTTTTTTTTTTTTTTTTTTTTTTTTTTT
TTTTTTTTTTTTTTTTTTTTTTTTTTTTTTTTTTTTTTTTTTTT
TTTTTTTTTTTTTTTTTTTTTTTTTTTTTTTTTTTTTTTTTTTT
L.....................CCC