C....#...C
..@..#....
.#####....
..........
#########.
..........
.#########
.....#....
#...##.##.
C.......#%