TTTTTTTTTT...###
TTTTTTTTTT..##.#.####
TTTTTTTTTT.##..#.#.-#
TTTTTTTTTT##K.$..$..#
TTTTTTTTTT#..$.$.#..#
TTTTTTTTTT###.$#.#.|#
TTTTTTTTTT.....#@..%#
TTTTTTTTTT.##.####.##
TTTTTTTTTT.#>......#
TTTTTTTTTT.#.^..^##