...###
..##.#.####
.##..###..#
##........#
#...@..#..#
###..###..#
..#..#....#
.##.##.#.##
.#......##
.#.....##