TTTTTTTTTTTTTTTTTTTTTTTTTTTTTTT
TTTTTTTTTTTTTTTTTTTTTTTTTTTTTTT
TTTTTTTTTTTTTTTTTTTTTTTTTTTTTTT
TTTTTTTTTTTTTTTTTTTTTTTTTTTTTTT
TTTTTTTTTTTTTTTTTTTTTTTTTTTTTTT
TTTTTTTTTTTTTTTTTTTTTTTTTTTTTTT
TTTTTTTTTT...###TTTTTTTTTTTTTTT
TTTTTTTTTT..##.#.####TTTTTTTTTT
TTTTTTTTTT.##..###.-#TTTTTTTTTT
TTTTTTTTTT##K.......#TTTTTTTTTT
TTTTTTTTTT#...@..#..#TTTTTTTTTT
TTTTTTTTTT###..###..#TTTTTTTTTT
TTTTTTTTTT..#..#...%#TTTTTTTTTT
TTTTTTTTTT.##.##.#.##TTTTTTTTTT
TTTTTTTTTT.#......##TTTTTTTTTT
TTTTTTTTTT.#.....##TTTTTTTTTT
TTTTTTTTTTTTTTTTTTTTTTTTTTTTTTT
TTTTTTTTTTTTTTTTTTTTTTTTTTTTTTT
TTTTTTTTTTTTTTTTTTTTTTTTTTTTTTT
TTTTTTTTTTTTTTTTTTTTTTTTTTTTTTT
TTTTTTTTTTTTTTTTTTTTTTTTTTTTTTT
TTTTTTTTTTTTTTTTTTTTTTTTTTTTTTT
TTTTTTTTTTTTTTTTTTTTTTTTTTTTTTT
TTTTTTTTTTTTTTTTTTTTTTTTTTTTTTT
TTTTTTTTTTTTTTTTTTTTTTTTTTTTTTT
TTTTTTTTTTTTTTTTTTTTTTTTTTTTTTT