...###
..##.#.####
.##..###.-#
##K.......#
#...@..#..#
###..###..#
..#..#...%#
.##.##.#.##
.#......##
.#.....##