##############.#..#.###
#.####.#
#.#.####
#...##...#
##K#.###
#KKK#....##
##K@.#.#..#
##K    .#.#.##
###...#
##..####
#########