##############.#..#.###
#.####.#
#.#.####
#...##...#
##.#.###
#...#....##
##.@.#.#..#
##..#.#.##
###...#
##..####
#########