##############.#..#.###
#.####.#
#.#.####
#...##...#
#..#.###
#...#....##
##...#.#..#
##..#.#.##
###...#
##K#.###
#KKK#....##
##K@.#.#..#
##K L  .#.#.##
###...#
##..####
#########
TTTTTTTTTT
TTTTTTTTTT
TTTTTTTTTT
TTTTTTTTTT
TTTTTTTTTT
TTTTTTTTTT
TTTTTTTTTT
TTTTTTTTTT
##########
#L....L..#
#KKKK...L#
##########