#############..##
###...#.#
##..####
####.##
##.#.#..#
##..##..#.#
#.##..#
##.#..##
##@.##..#
######...##
############