##############.#..#.###
#.####.#
#.#.####
#...##...#
#..#.###
#.L.#....##
##.@.#.#..#
##..#.#.##
###.L.#
##..####
#########