##############.#..#.###
#.####.#
#.#.####
#...##...#
#..#.###
#...#....##
##...#.#..#
##..#.#.##
###...#
#LK#.###
#KKK#....##
##K@.#.#..#
##K .  .#.#.##
###...#
##..####
#########
TTTTTTTTTT
TTTTTTTTTT
TTTTTTTTTT
TTTTTTTTTT
TTTTTTTTTT
TTTTTTTTTT
TTTTTTTTTT
TTTTTTTTTT
###L######
#........#
#KKKK....#
##########