#############..##
###.######
#.#...#.##
#####..#.#
#.#.###.##
##.###..##
#..#@##
#....##.##
#..#.#.##
#.####.#
#########