#########.....#
###...#
#.#.#..#
#.@##.#.#
#.....#
#####.#.##
##.#####
##.########
#....######
#.##.##.###
############