##########....#
#@##..#.###
##.#.##
#.###..#
#......##
#.##.##
##.####...#
#.##..#.#
#.....#.#
#..##.#..##
############