#############....#.##
##..###
###..##.#
#..##.###.#
#....##.##
##....#..##
##.###...@
#..#..#
#..###.###
##.....#.#
###########