############.##
#..#....#
#....##
#.##..#.#
#...####.##
#.####.#
#.###...#
#.###.###.#
###.###@#.#..#.##.#
############