#############...#..##
#####...###
#####@#..#
#.....###.#
#..#..##
##.####
#...#..#.#
#..#...#
###..#..#
#..###.####
############