##############.###..###
#..#.###
##.#####
##...#....#
##.#.#.###
#.......#
#...#@#
#.###.#.###
##..##....#
###..#.#
#########