############.#..###
##.##.#
####..#.##
##.##....#
###....#
##......#@#
##.###.##
#.##.#.#
#..###.#
#.#..#..###
############