@..###.....
..##.#.####
.##.......#
##........#
#......#..#
###..###..#
..#..#....#
.##.##.#.##
.#......##
.#.....##