#############.####.##
#....#...##
#..#.#.###
#.#.##.#
###.##.###
##..####.#
######..#.#
#.##.##..#
#######.@#
#####...##
###########