###############
#..####.###
#...#.#...#
#####.#
#..#...#
#..#.##..##
#####...#
#..##%#..@#
#....#.#
##.#.#.###
###########