#############...#..##
#..@#..#
#####.###.#
#.###.....#
###..#....#
###..#..#
##.#..##.##
###...#..##
#.#.####
#.#....##
##########