#########..#.##
#.##@.#
####...#
#..#..#.###
##.###.#
####.#.#
#...#..#
##.#.##..#
#.#.##.###
###...##
#########