............................................
............................................
............................................
............................................
............K..........#CCCCCCCCCCCCCCCCCCCC
............................................
............................................
..................@.........................
...................................%........
............................................
............................................
............................................
#CCCCCCCCCCCCCCCCCCCCCCCCCCCCCCCCCCCCCCCCCCC
#CCCCCCCCCCCCCCCCCCCCCCCCCCCCCCCCCCCCCCCCCCC
#CCCCCCCCCCCCCCCCCCCCCCCCCCCCCCCCCCCCCCCCCCC
#CCCCCCCCCCCCCCCCCCCCCCCCCCCCCCCCCCCCCCCCCCC
#CCCCCCCCCCCCCCCCCCCCCCCCCCCCCCCCCCCCCCCCCCC
#CCCCCCCCCCCCCCCCCCCCCCCCCCCCCCCCCCCCCCCCCCC
#CCCCCCCCCCCCCCCCCCCCCCCCCCCCCCCCCCCCCCCCCCC
............................................
............................................
............................................