############.###..#.#
###.#.#
##.##..##
##...##
##.#..#
#.#...#
#....##.@#
#.##..#.###
###.###
#.....#
########