#############..#####.##
#.....#.##
##...#..#
#.#.#.#
###.###..#
##....#..#
##....#@#....#.#
#...#.#.#
##..#.#.#
##########