###########.#.#.#.#
#.#.#..##
##..#..##
#....#..###
#.#.#.#
#..##..#@###......#
##.###.##
#.##...###
##....###
##########