#########...###
#.#..###
#...#####
#..#.##@.#
##.##..###
#.#.#.#
#.......#.#
#.#.#.##
##..##..###
#####.#
########