############..##.#..#
##..#..#
#...###
##..##.#
#.##.#.#
##.#.##
###.#.#.#
####..#
###.#..#@.#
####.###.##
############