############.#..##..#
#.#..##..#
#.######
#..#####
#..#.##@##..#.#.#.#
#..##.###.#
#....#.#.#
###.##..#.#
######..##
###########