#################.###
#####.#.#
#.##..##
###...#
#######
#.####.#.#
#.#.#.##
#.#.##.#
#.#.##.#.@
##.#.##.###
############