###########.#.#..##
####..#
#...@.#
#.#..#...#
#....#.##
#...##.##.#
#.#....#..#
#####.....#
#.#..####
#.##..#
########