###############
##.####
##.#####@#.##..#.#
##.######
##.....#.#
#..##.#
##..#...##
#..###.#
##...#...#
###########