#########.#.###
####.....@
#..#...#
#..#.#####
##.##.##
#####.#
#....##
#..#..#.#.#
##...###
#..#..#
########