#############.##.#.##
#.......#
###.....#
##.#.#...#
##....###.#
####.##
##.##..##
##..##.#..#
##...#@..#
#....##
########