#########..#.##
#..####
####...##
##@.#..#
#...#.#.#
###..##.##
###.###
#.#.##.#
#..#..##.#
#..####
########