#############.#.###..##
#.#..#....#
#....#.#
##.###@#
###.#..##
#.###.##.#
#...#.....#
###..#.###
##..###
#..#.#####
###########