##############..#.#.#
#.######
##.##.#.#.#
#.#.@#...##
#...#.##.#
#..####
###..##..#
#.#.#..#
#.###.#
#...#.#.#
##########