#############.##..#.###
#.#.#...@#.#.##...#
###L...###
##...#.#
#...#####
#L......###
#.....####
###.#.L...#
###L#..#
###.#####