#############.###.#
#....##
###@###
##....###
#####..##
###.#..#
#....#.###
###....##.#
####..###.#
###########
############