#########.##..#
#.###@.##
##....##..#
#.##.....##
##..####
#.##.###.#
#..#.#..#
###....##
###.#..##
##...###
#########