################..#.#
###...#...#
##.....#..@
###..###
######....#
##..###
#.#.######
#.##.#..##
###..##
####.#.##.#
############