##########....#
#.......###
##.#.#.@
##....#####
#....##.##
##.#.#.#
#.#...#
##.##.##
##.#..#
#.#######
##########