###############..#..###
#.#.@#.#.##
##..#.##
#...###
#.#..###
#.######..#
#.#.####
#.#.####
##.##..#
##.###.####
############