#############.##..#.###
#.#.#..#@#.#.##...#
###..#.###
##..##.#
#..######
#......####
#.##.#####
######...#
###.#.##
#########