#############...#...#
#.#.#@#
##.#.##
#.#.....#
#..##.####
#...#.####
#....#.#
#....######
#..#....#
##.##.#
########