##########.##...#
##.#..#..#
####.#.#.##
#...##...#
##..##...#
##.#...#
#.###.#
#.#.@..####
#.#.##...#
#.##.#.#
#########