##########..#.#
####.#.###
##..##.##@#
#.##.###.##
##.#..#.##
##.#.##
#.#.#..##
#####.##.#
##.##..#.#
#.#.#.#.#.#
############