#############...#.#
#...#...@#
####.....##
####.##.#
#.###.#
#.#####..#
#.#.#....#
#.#.#######
#.#.##.##
#.####..#
##########