###########.#.#
#...##.###
##...###
##.##..#
######..#
##.#.##.##
#.#.@..#
#.#.#....#
##.###..#
##.#..#..##
############