###########.##..#
#.###..#
##..#.##
#.#.#.#
#..#.##
##..###..@#
#...#.#
##...#..###
#..#..#
###.#..#
#########