###############
##.####...#
####.#..#
#..#.###
###..#.#..#
#.@.####
##.####
#.###....##
#..#..#
##.##...#
##########