#########.....#
#.###....##
#.#.##.#..#
#..#.#..##
#...#.#
##..###..##
###.###
###.@##.#
#.#.#..#.##
#..#.##
########