###############...@##
#.#.#.#
######....#
####.##
###.#######
#.##.#.###
#...##..#
#..#..#
####.##
##...#.####
############