##########..#.###
###...#
#.##..#.##
#..#.#.#
#...####
#..@##.#.#
##.##..###
#.#..#...#
##.#.##
##...#.#
#########