##############......#.#
#.....#..##
######.#
#.#####
#.###..#
#.#..#.#
#.###..##
#@####.#
###...#
##.......#
###########