###########..#....#
#.#..##@#######.#
###..#.#
###.###.#
#....#.#.#
#..###.##.#
###.####..#
#..#....#.#
#.#.#.#
########