#############....#..###
#.#.##.#
#...###
##....#.#
##.###...##
##.#.#...#
##.#..#
#@##..###
#.#####
##.#..#
########