##############.##.#.###
##..####
#@.###.#..#
####.#..#
#.#...#
####..#.#.#
#.##.####
#.###.##.#
###.#...#
#..##.#.#
##########