##########..#...#
#.##...###
##.##..#
#.....##
#.@...##.#
####.##.#
#.##.#...#
###...##.##
##..###.##
####.##.#
##########