###########.#..#.##
#.###.##
#..###.#
##.#..#
#.####..#
#@.#.....##
##..##.#
#######.#
##.#....#.#
#....#..##
###########