##############..#
##.###.#
#.#....#
#.####.#.#
####...#
##.#######
#....#..##
#...##.#
##..@#.####
#...#.##
#########