###############......##
##.####.#
#.##.#..##@#######
##...##
##...#...#
##.##..#.#
#####..####
#.#.##.#.#
#...#.##
#########