#############.#...#...#
##.#.#..#
#.#...#.#
##..#.#
######...#
#.###...##
##...#.@
##.##.##.#
###...##..#
#.###..#
#########