############.########
##.####
##.#.#..##
##.##.#
#.#..##
##......###
####.###@##..####
#..#.##
#.....#
########