###############...#...#
#.....##.#
##.#######
##.#.#..#
#@..###
#.##.###
##.#.#.#.#
##.##.#
##.#....#
#.#....##
##########