#########.#.@##
#.#.####
#..####
#...##..##
#...###.#.#
#.#....#
##..####
##.###.#.#
##..##.#
#.#.#.#####
############