##########..###
#......##.#
###...##
####..##.#
##.####
##@##.##
#......#
##.##.#.##
#..##.####
#...#..#
#########