###########...###
##@...#
#.#..###.#
#..#.#.###
#......#
##.##.##..#
#.......#
#.#..##.#
#.#.....#
#.#....#
#########