##############....#.#
#..#...#.#@##.#####
##...###
##.....#
###..#...#
#.#.#..#.##
#.##..###
##...#..##
#.#.#..##
##########