#########.###.#
#.##.#.###
#....####.#
#.##.##.###
####..##..#
#@##....#
#.#.##....#
#....##
#####.#
#.####.#
#########