############.###.#.##
#..#..###
####..##.#
#..##..#.#
###.#..#
##.@##.###
####..#
#.#..##.#
#.##..#.###
##.#..#
########