#########.#####@##...#..#
###.##.#
#.#..####
#.#..#..#.#
###.#...#
#.#..#...##
#...#.###.#
##.###.#.##
#.#.#.#
########