###############.#
#..@..###.#
##..##.#.#
#..####
###.#...##
#.#....#
##..#.#.#
##...##.#.#
######..#
##.####
########