#########...#.#
#..#...#
###..@.###
##.####
#......#
##..##.###
###.#.#..#
#.##..#
#.#.....###
#.#...#..#
###########