###############..#.##
###...#.##
####.#..#.#
#.#..######
####.##
#......#
###.#..#@##
#.#.#####
#.....##
##.###....#
############