##########..#.#
##.###.##
##.@###
#..#####.##
#.##..##.#
#..####
##..#..#
##.#...#
#....#.#
#.#.####
#########