#############...#######
#######
#.###.####
##.#..###
#.@.#..#
#.##..#
#..#....#
###...#
#.###.##
#.#..###
#########