...###
..##.#.####
.##..###..#
##........#
#......#..#
###..###..#
..#..#....#
.##.##.#.##
.#......##.
.#.....##.@