############.....#.##
#.#...#
##...###
#.#.#...##
#....#.#..#
#.#.###.###
#..#.####
##...#.@##
##.##..##
##.#...#
#########