##############@#.##.#.#
####...#
#.....#
###....#
##...#..###
##..#####
#..##.##.#
#..#......#
#....##
#####..###
###########