###########.@#..###
##.....#.#
###...###
###....#
###.###
#....###
###..#..#.#
####.####
#######
#..#.#.#.#
###########