#############.#..##.###
###..##
####..#
#.#...#.##
##.##..#..#
#.########
#.##.###
####.....#
##...####@#.#.##..#
##########