#############.#..##
#.#.####
####.#.###
###...###@#......#
####.#..##
#.##....#
#.#.##.#
###.###..#
##..###.#
##########