#############...#..####
#@#.###.#
##...#..#
###.###
#####..#
#.#######
#..#..#
###.##.#.##
####.##.#
#..##.#
########