##############.##.....#
#.#.#..#.#
#.#.#.###
####..##.#
#####..#
#.#.#.#
##..#.#
####.##
#.@####
##.##.#####
############