###########..#..#
#..@.#..#
#####.#..#
#..#..##
#.#.#..#
####.##
#.#.###
####..###.#
#####.##
#..###..#
##########