##############.##.#...#
#.#.#.#.#.#
#...##.#
##@.#.#
#.#####.#
####..#...#
##.#.##
#..##.##.#
#.########
##.#######
###########