##########...#.##
##.###.#
#....@##..#
#.#..#..#.#
##..###
##.####
##..#..#.#
#.###....#
####..##
#.#.####
#########