###########..####.#
#######.##
#..##.##
####...##
##..@#.#
##..###
###...###
###..#..###
##..###
##......###
############