###########.....###
##@.#...##
#.#####
##.....#.##
###..##..##
#...#.###
##...####
##.#.#.#
##.#..##
#.#####
########