############.#...#..#
##...#.###
##.####
###..#.#
#.@##.####
####.##
###....#
#.#...#.#
##.#.####
####...###
###########