###############..#.#..#
#####..###
##...#.##
#.###.####
###..#.#
###.#.#
#.#.#.#
#.###@.#
###.######
##....#
########