##############..#
##....##..#
##@....#
#...###.#
##.##.#
#..#.#....#
##..#..##
#..#.#.#..#
#...#.##
#.##.##.###
############