#############.#..##
#.#.####
####C#.###
###CCC#..@#......#
####.#..##
#.##-...#
#.#.##%#
###.###..#
##..###.#
##########