#############.##..###
#.#.#..#
#..#..##
#....####.#
#.##..##
##.....#.##
##.######
##.#.#..##
#.@.#..###
#..#.##
########