###############..##.#
#.#...#
#.#...#
#.#..#.#
#.....##
#..##.####
##.@.#....#
##.#.#...##
##.#..##
#.#.#.###
##########