##############..##.####
###..#.#.##
###..#.#
#..####.##
##...#...#
#.#.####..#
###.#.@
##...##..##
#..##..#
##...###..#
############