###########..#....#
#..#@#.#..#
##..#.#
#..####...#
#######
#.##..##.#
#....##
#..##.####
#...#.#
#..#.####
##########