#########.#..##
#.....#
##.#.##
#.##@##
##.#.###
#.#.##.##
######.#
#.#.###.##
#.##..#.#
#.#.##.#.#
###########