###########...#
#####.####
#..#.##
##....#@#
#.#.##..##
##..#..#
##..##..#
#.##....#
##......###
#.#..####
##########