#########.#.###
##.##.##.#
########.#
#......##.#
#.#.##.###
#.###.#.###
#.#.#.##.#
#.##.###.#
#.###.#@#
##..##...##
############