############.###.##
####..#.#
##..##.###
#.##.....#
#.#...#.#.#
##@####.##
#...###
#...#####
#..##...##
#.##....#.#
############