###########.##...##
##.##.##.#
##.##..#.##
##..###
#.#.##.#
####..####
#.##.###
#.##...###
#.#@######
##..#.#..#
###########