###########.#.###.@
###...###
#.##..#...#
####.###.##
##########
#..#...###
#.#####
#.#.##.###
##.....#
#..####
########