############....#.#
#...#..#
########
#.#.##...#
#.#.##.#.#
#.#...##
#.#...#
##..##..#
#..#..@..#
#..#.#.#..#
############