############.#.##..##
##.#.#.#
###.@...##
#..#.###
##.#..#
####.##
##.#...###
###.#####
#..#...#
#.....#
########