###########...###.#
#.######.#
##@###..###
#.#......#
#..###..#
#.##..#
###.######
#####.#.#
#.#.####
#.###...#.#
############