#############.###.#.#.#
########
###.##.##
##.#...###
####.##
#.#...###
##.##...@#
#.###.#.#
#...#..#.#
###..##..##
############