############.#.....##
##....##
#.#..@#
#..##.##
#...#....#
###.#.#
#...#.##.##
#..#.#.#.##
#...###..#
###....####
############