############...##.###
####.#.#.#
#..#..#
##..#.#
#.....###.#
#.#..##
####...#
#.##..####
####.@##
######.#
#########