############..#######
#...#..#..#
#.#.#..##
###.#.##..#
#....##
#.#...#
#..#..#
#.#@.###
#.##....#
###.#..##
##########