##########.#....#
#...###
#..#.#.#.#
##..##.##
###..####.#
##.#.#..#
#..@.##..#
#...##.##.#
##.#..##.##
##...##...#
############