##############.###.##
#.##.#..#
##.....####
##......#.#
#....#..#
####..#.#
#####..#@#####..##
##.##..#
#.####....#
############