##########.#..###
#######
#.###..#..#
#.#..##.###
#.#..###
##...#..#
#..#####.#
#..####.##
#@#.#.#.###
#.........#
############