#########.##@.#
#.....#
#..#..#
#.#..#.#
##.#.#.#
#..#..##
#####..#.#
#.#####.##
#..####
#.######
#########