###############..#.#.##
#..##.#
###..#.#..#
#.##...#.#
###...#..#
##..##...##
##.#..#####
#..##.#
#..##.##@#.##..##
#########