############.#.####
#..###.L#.#
##......#
##.##.##
##.#...#
###..@#
#######
#%.#####
##..####
####.L#
########