##############.#.#..#
##.#....#
###...#.##
####@#...#
#.#..#.###
#..#####
##.####
#####...##
###..#.#
#.#.#.#
########