###########.#.###.#
####.##
#...#..#.##
#.####.@
###.....#
#...###.#.#
#..##.#
##..##.#
##.##.#
#..#.##
########