############...####
###.#.#...#
##..#.#
##.#.###.##
###..#.##.#
#.#.....#
#.#####@##.#.#...#
#####..###
##.##..##
##########