##############.#.#..#
#.....#.#.#
#####.#
#@##.#.##
#...##...##
##.##..#..#
#.###.#.#
#####.#
##..###.#
#..#####
#########