############..##..#
##.##.#
#..#####
#....###
###.#.##.#
##..#@#.#
#..#.###
#####.#
##.##.##.#
#....##
########