############.#.####
#..###..#.#
##......#
##.##.##
##.#...#
###..@#
#######
#..#####
##..####
####..#
########