#############.##..#@#
##.###.##
#..#.##..##
#.##...#
##..#####
#.....#
##...##.#
#...###.#
#.##.#..#
#......###
###########