############...##.#.#
#.#.@#.#
#..##.####
#.####..#
#.#....##
#######
#.###.#
#..#...#
#.#.###
#..#.#..###
############