#########..####
###.....###
####..#
##..#..#.#
##......###
######.#
########@
#.######.#
#......####
#...###
########