#############.....#.###
#.#####@#
###.##..#
##.#...#.#
##.####
###....##
#.####.#.##
#..##.##
##...####
##..##.#
#########