################..#
#.##.##...#
###...##
##.#...#.#
#...####.#
##.....#
#.#.#..##@#.##....###
#..#.####
#.....#
########