##########...##
#.#.##.#
#...###
##...#####
##.##.##
##@...##.#
#..#...#.#
#..#####
##.##..##
##.###.##
##########