##########.#.####
#.###..#
##.#.##.#
#..#.####
##..#.##.##
##..#.####
#.#.#..##
##..##..###
#@.###.##
#..#.#....#
############