##########.##..##
####....##
##...##
#......##
#.##....#
####.#.@##
##.##.#
#.#.##.#
#.#..##.#
#######
########