##############.#.#....#
#####.#.#
#.###.##.#
#.#.@.##.##
#.#..###
###.#####
#.....#.###
#..#......#
#.....#
###...#
########