##############..#.@
#.##.###.#
##..#.#
#..##.#.#
#.#####
#.#####
#..#..#.##
###..##
#.#..#.#
#.#.#.#
########