#########..#.##
#....##
#.#####
#.@...##
#.#..##
#...#.#.###
#.#.##.##
#...##.###
#..#..##.#
####..#
########