#############...#..#.##
###......#
####.#.#
#.#.##..###
######.#
#..#..#.##
##.#.#...#
#..##..@##
#.##.######
###...##
#########