###########..#..#
#..####
#...#..##.#
##...####
#..##.#
#.@...#
#...#..#
###.#.#####
###...###
####.#...#
###########