############.#.##.#.#
#...##.#
#..#.#..#
##.#..#..##
##..###.#
####.#.#
##...##
#.#.#####
##...#.#@##
##.#.######
############