##########.#.#..#
##.#..#.#
#.....#
#.###.#
##..#...###
#..##..#
##.#.##
#..#..##
#...@.#.##
###...#.#
##########