#########..####
##...#..#
####..###
#.##.#..#
#..@.#####
##..#.#
#.......#
#....#####
#....###
#.##.#####
###########