############..#..##
####..#.#.#
#..##.#.#.#
#.###.....#
#..###.##
####....##
#.##.@#.##
#..##.##
#.#.#.#.##
#.....###
##########