#############.##..###.#
#.#.@##
#.#...#.#
##....##.#
##.#.##
#.#####
#....##...#
##...#..##
#.#.####.##
#..#.###
#########