###########.#.#
#####....##
###...###
#..##@.##
#.#.###
####..##
#.#...#..#
#.#.##.#.#
##.####
####..#
########