############..#@...##
#.#..#.####
#..##.#
#.#...#
##.###..##
##....#...#
#.#.#..####
##.#..##
###...##.##
###.##.#.#
###########