###########.....#
###....##
#...#.#
#.#.###..#
###..#.#
####..##@##
#..#.#..#
##.###.#
#.###..#
#..#..#
########