############...#..#.#
##.#####
##.#..##
#...#..#
##..#.##@#
##.#.##...#
#..##...###
###.##.#..#
#####..#
##.##..#
#########