##########.######
#.#..#.#
##..#...###
###..####
##.####.#
###..#.##
#.#.##.#
##.#...#.#
#..#..#..@#
#.#...#
########