##########...##
#.#.##.#
#CCCCCC###
##...#####
##.##.##
##@...##L#
#..#CCC#%#
#..#####
##.##..##
##L###.##
##########