##########.###..#
##...##..#
#..##...#
########@####.###
#.##.###.##
####.....##
#...###..#
##...#.####
##.##.##
#########