###########.....#
#.#.##.##
#.####..#
###.#....##
#.#.@..#..#
#..###.#.#
#######
##.##.#.#
##....#
#.#.#.#.#.#
############