############.######
#.#.#..#
####.####
##.#.#####
#.##.##..##
#.##...#
###.#.#
#.####.#.#
##.#.@###.#
#..##..#
#########