#############.#
##...##
###..##
#...#.###
#...##.##
#.@..###
###.###..#
#.####....#
#.####..##
#..####
########