#############.###.#
#.#@..###
#..#.#.###
#..#.##
#...#....##
###....##
###..##
#...#.#
###.###
####.###
#########