###########.##..#
###.#..#
#####.#.#@##.#.##
#.#####..#
###...#
##.#.##
#######.##
#...###
#.##...##
##########