#############..##
#@..##..##
#.#.#..#
#...#.##
####.##
#....#.#
####...#.#
##..#.#..#
########
#......####
############