############.##.#
##...###.##
##@...###
#.#...#.#
###.##..#
##..###
#.#####..#
##......#
##....##
#.#..##
########