############.....##
#.#...##.#
#..####
#.#.#..##
###..####
##.##@##
##..#.#.#
#..#..#
###..#.#.#
#.##.#.###
###########