############..####.##
#.###..##
##.####..#
#..#..#.#
######..#.#
#.#..#..#.#
#..######
#..##.#
#..##..#..@
#.#.###
########