##########.#.#..#
####...###
###..#.##.#
#...####
#.....###
##...###
##....##.#
#.#..##
#..#.@..#.#
#...#.#.#
##########