###############...#.#
#..#..#
###..###@
####.###
##...##
###...###
####..##
###.##.####
##.##....#
######..##
###########