#############.#.#...#
###@...##
#...#.####
##.#.###
###.#.#
#.#..##
##.#...#
#..##.#..#
##..#.#
####..###
##########