############..####.##
#.###..##
##.####...
%.L#..#L#.
#########.#
#L#LL#LL#L#
#..######
#..##.#
#.....L#L.@
#.#.#.#
#####.###
#####L###TTTTTTTTTTTTTTTTTTTTL.........CCCK
