#############.....#
##...###@#
#####.##.#
#..#.##
#.###..#
#.#...#.#.#
#.###.####
##.#.##.###
##.#..#.#
###...#
########