##############.####
####@##.###
#..#..###
#..##..#
#...###
##..#..#
#.....##
#.#.#...#
#..##.##
##...#.#
#########