##############...##.#.#
##...#..##
#####.#
##...#...#
##.#.#.#.##
###...#
#..###...#
##@.#..#..#
##....###
###.#.#...#
############