############..##....#@##...##.#.#
####....#
###...#..#
##..#.#####
##..#####
#.#..#.#
#.#....##
#####.#
###.#.#
########