##########.#....#
##..##.#.##
###.#.#
#..###..###
##..###...#
####.##.#
##.#.@#
##.##..#
##.###..###
####.##.#
##########