#########..####
#..#.##
#..##.#
####.#.##
#.##@##
#....##.#.#
#.#...####
##...#.###
###.#...#
####..#
########