############..#...#
##.#.#.##
#...#.#
###.##.@###
###.###
###....##
#..#.####
##.#...#
#.####.##
#.###.####
###########