#############...#.#..##
#..#..##
##..####
#.@..###
#..#..#.#
#...###.###
#####..#
###.#.#.#
####..#
#..###...##
############