#############...###
###.#.#
#.####...#
#..#.#.#
#.###.#..##
#...######
####...#
###.#.##@#.#####.#
#..#..##
#########