#############...###
####.#.#
##....#.#
###..##
##.##.##
##.#####.#
#.#.@.#
###.#..##
##.#.##
#..####
########