##############..#####
##.###...#
#..#...@
###.#####
##....#...#
#.....#
#....##.##
##.##.####
####...##
####.###
#########