############.####.#.#
##.##.#.#
#####.#.#.#
##.#..##
##.#.#.##
#@##.###
###..##.#
###..##
#.###...##
#.##..#
########