############..@##
#..####
#.#.#.##
#..#...#
######..##
#......###
##...#.#
#..#..#
#####.#
#.#..##
########