############.####.#.#
##C##...#K.
##.##.#.#.#
##.#..#...C
##.#.#.##
#@....###
###.L##L#
##...##.
#..##...##
#%.#C.#
########