############...##@##.#..####
###...#..#
#.#.#..##
#.#..###
#...###.#
#..##..##
######.#
##.#.....##
#.#.#.##
#########