############.####
#..#...#
#@.##.#.###
##...##
#....####
#..###..##
#...##.#
#.##.###
##.#..#...#
##...##
########