##########...##
#.....#
##....##.##
###.#.##
#.#.......#
#.##...#.##
##.#@###
##.##.#..##
#.#.###.#
#####..#.#
###########