############.#.#..###
#.#..##
###.#..#
#...##.#.@#
##.##.#
#.###.####
#.##..##
#..##...##
#..#.##.###
#.#.##..#
##########