##########..##..#
##.#..##..#
#..###....#
#.###.##..#
##.###.###
#...###.#@
##.######
###..###
####..#..##
##...####
##########