##########.....##
#@#.###
##....##
##...####
###.#..##
#.#####
#.#.##...#
#.#....#
#.#..#.#
##.#...##
##########