##########.#....#
###..##
#.#...##
####.#.#
#..######
##..@#.##
##..####
####.#####
##....#
#.#...#
########