#############.####.#..#
#..#@.#
#.###.##.##
#.#####..#
##.#...###
##...###.#
#..##.#..##
##..##..#
###...##
#.....#
########