############.##..##
###.#....#
#.#..#..###
####.######
#.###@#
#..##.##
#.###.##.#
###.###..#
###.##.#
#.##.##
########