############..#.###.#
######.#
##..###
#...#.#.##
#....#..#
####...#.#
##..@###.##
##.###.#.#
###..#.#
####..#
########