##############...#..#.#
#..#.###
#..#####
#.#..##
#..##..#
#..#..#.#
#..@...##
#.....###.#
#...####.#
##..#.#
########