###########.##....#
##@###.#
##...###
#.#..##
###..##
#....##
###.#####
#.##.#...##
##.#.##..#
##.###.##
##########