############..#.#.#.#
##.......#
##@..#.#
#.###...##
#.###..#
#..####
#.#.##.#
#.#.#.##
#..#..#
#..##..#
#########