##############...##...#
####.#.###
#.#.##...##
#.@..#.#
####..###
###...##
#...#..####
#.....#####
#.#.#...#
##..###
########