##########..#..##
##.#.####
###.###...#
###.#..#
#.#.##.#
#@.####.##
##..###
#..#..#.##
#.#...####
#.#..#.###
###########