###############..#..###
#..#..###
#.###..#.##
####....#
##....###
#..##..##
#.#..##..#@##.##.##
#.#..##
##.##.##
#########