#########...@##
#..#.##..#
##..###.#
#..#.####
##.###..#
####..##.#
#.##.#.#
########
###.###...#
##..##.#
#########