##########...##.#
#########.#
#..##.###
#..###..##
###...#
#..####
##.#..##
###..@#.##
#.#.#.#..#
##..#####
##########