############@#....###
##.##.#
#####.##
##..###
#.###.##
###..#..#
###.#.#...#
#...##.#
###..#..#
#####..#
#########