#########.#.#.#
####.###.#
######@##
##.#...##.#
###.#.##
##....#.##
#..#....##
###.#.#
###.#.##.#
##.#..##
#########