##########..#.#
###....###
##...#.#
###.....#.#
##.#..###.#
######...#
###.#.#..#
##..#@#
#########
###.#.#
########