##########..#.###
##.@.#..#
#.....#.##
#.###.####
#.....#...#
#.#.##..#
##...##
##.....#.#
#..##.##.#
#######
########