############.##.#..##
#...##@###
#.##..#.##
###.##.##
#..#..#
#...#...#
##...#.#
##...#.#.##
#.#...#..#
######.#..#
############