##########.##.###
#####.##.#
#.##.###
#@.....###
#..####.#.#
#...####
##.#..###
#......#.#
####.##..##
#.....##
#########