#############...#.#...#
##.#.##
#.#.#.#.##
##.#.##
##.......##
#.####.#
#.#.#..##
#.####.##
#.####.@#
#...#.###
##########