#############.....##..#
##..##@##
#.#....#
######..##
#.##..####
#.#.#....#
###.##.#
#.##..##
#..####.#.#
###.####
#########