##########.###..#
#.#.###
#.###.##
##..#..#.#
#.#....##.#
#.#..##..##
#.#.#.##.#
##.@...###
###.#.####
##.#.#.#
#########