#############.#...#
##.###..#
#...####
##@..#.####
#####..#
#.####.#
#.....##
###..####
##.#...#
##.#..#..##
############