############.##..##
###.#.###
##.##.#..#
##...##.#
##..#######
#.....#.#
##...##.##
#.#@##...#
##...##
#..##.##.##
############