###########C#..K#.#...#
#........L#L....
#.#.#.#.##
#..#.##
#$.....-.....C##
#.####.#
#......##
#.####.##
#.####.@#
#..L#L###
#####..%.%#