#############.###
#.#.#.##
#.......#.#
###.###...#
#.@.####
#.#...#
##.....#.#
##.#.#...##
#..#.#.#
#....##.##
###########