#############.###...#
#..##..#
##..#..#
####..#..#
####.#.###
##....#.##
#...#.#
#...#.@
#.#..##
#.####..##
###########