#############.#...##..#
#@.#..#.#
##.###.#
#####..#..#
#..#.##
#####.#
###..#.##
####.#.#..#
#..##.###
#.#####
########