#############..###.##.#
#.##......#
###.##...#
##..#..#
#...######
###.#.#
#..##.#.#
#...##..##
###..@#.###
###....##.#
############