##########.#.#.##
#.##.#.#..#
#..#####.##
#.#..#####
#.#..#.##
#.#.#.#
#####.#..#
#.@.##....#
##.#..###.#
#.##..#.##
###########