#################.#.###
#.#...#...#
##.##....##
###.###
####.#..###
#..###.##
###...##.@#
#.#...###
#...###
#.#..##
########