###########.###
#.#.#...#
####...#
####...###
#.#..##..#
########
#.###..##.#
#....#.#.#
#.##...##.#@#..#..#
########