##########.####
#...####
#.###..#
#.##.##
#.#.##.#..#
####..#
#.#@#..#
#.###..#
##.#.#####
#..#.#####
###########