###########.###
#.#.#..%#
####...#
####.@.###
#.#..##..#
########
#.###..##.#
#....#.#.#
#.##...##.###..#..#
########