#########..##.#
#...##.##
#..#####
#.###.####
#.###...###
##.#####
#.##..#
##@.#...##
####.#.#
##.##.#.##
###########