###########..####
#.#...#.#
##..#.#.###
#.###.###
#.#.@..##
##..##.#.#
#..#.##
#.#.####.##
##.......#
##.####
########