############.#..#.###
#.#....#
#.#...#####
####.....##
#@.##...##
###....#
###.....##
#.###..##.#
#..#..#
###....###
###########