###########.#.....#
#.##.##
####....#
#.....#####
#.##.##.###
##.....@.##
##..#.##..#
#.#...##
#.##..#..##
##...#.#.##
############