###..............###
....................
...@....######......
..........K.........
###.................
.............#####..
....................
....##........##....
....................
...................%